10000000010000000000000000000000000000000000000000000000001
02222222202222222222222222222222222222222222222222222222220
02222222202222222222222222222222222222222222222222222222220
02222222202222222222222222222222222222222222222222222222220
02222222202222222222222222222222222222222220000002222222220
02222222202222222222222222222222222222222222222222222222220
02222222200000002222222222222222222222222222222222222222220
02222222222222222222222222222222222222222222222222222222220
02222222222222222222222222222222222222222222222222222222220
02222222222222222222222222222222222222222222222222222222220
02222222222222222222222222222222222222222222222222222222220
02222222222222222222222222222222222222222222222222222222220
02222222222222222222222222222222222222222222222222222222220
02222222222222222222222222222222222222222222222222222222220
02200000002222222222222222222222222222222222222222222222220
02222222202222222222222222222222222222222222222222222222220
02222222202222222222222222222222220000000222222222222222220
02222222202222222222222222222222222222222222222222222222220
02222222202222222222222222222222222222222222222222222222220
02222222202222222222222222222222222222222222222222222222220
10000000010000000000000000000000000000000000000000000000001
