10000000000100000000000000000000000000000000001000000000001
02222222222022222222222222222222222222222222220222222222220
02222222220222222222222222222222222222222222220222222222220
02222222202222222222222222222222222222222222220222222222220
02222222022222222222222222222222222222222222220002000000001
02222220222222222222222222222222222222222222222222222222221
02222202222222222222222222222222222222222222222222222222220
02222022222222222222222222222222222222222222222222222222220
02220222222222222222222222222222222222222222222222222222220
02202222222222222222222222222222222222222222222222222222220
02022222222222222222222222222222222222222222222222222222220
10222222222222222222222222222222222222222222222222222222220
02222222222222222222222222222222222222222222222222222222201
02222222222222222222222222222222222222222222222222222222020
02222222222222222222222222222222222222222222222222222220220
00000200022222222222222222222222222222222222222222222202220
02222222022222222222222222222222222222222222222222222022220
02222222022222222222222222222222222222222222222222220222220
02222222022222222222222222222222222222222222222222202222220
02222222022222222222222222222222222222222222222222022222220
10000000100000000000000000000000000000000000000000100000001
